R 1920 1080
NO ./texture/WALL32.xpm
SO ./texture/WALL53.xpm
WE ./texture/WALL88.xpm
EA ./texture/WALL89.xpm

S ./texture/BAR1M0.xpm
F 200,1,11
C 148,235,255

        1111111111111111111111111
        1000000000110220020000001
        1011000001110000202002001
        1001000000000000N00200001
111111111011000001110000000000001
100000000011000001110111111111111
11110111111111011100000010001
11110111111111011101010010001
11000000110101011100000010001
10002000000000001100000010001
10000000000000001101010010001
1100000111010101111101111000111
11110111 1110101 101111010001
11111111 1111111 111111111111
