R 800 600
WE ./texture/WALL32.xpm
NO ./texture/WALL53.xpm
SO ./texture/WALL88.xpm
EA ./texture/WALL89.xpm
S ./texture/BAR1M0.xpm
F 255,255,255
C 148,235,255

     111111111
111110001
1000000111
1000N21
1110111
  101
  1011111
  10000201
  10200001
  10002001
  11111111
