R 800 600
WE ./texture/WALL32.xpm
NO ./texture/WALL53.xpm
SO ./texture/WALL88.xpm
EA ./texture/WALL89.xpm
S ./texture/BAR1M0.xpm
F 255,255,255
C 148,235,255

     111111111
111112221
122222111
1222N21
1111111
