R 1000 600
NO ./texture/WALL32.xpm
SO ./texture/WALL53.xpm
WE ./texture/WALL88.xpm
EA ./texture/WALL89.xpm

S ./texture/BAR1M0.xpm
F 65,70,71
C 148,235,255

             11111111111111111111111111111111
             10000000000020000000000000000001
             10011111111111111111111111111001
             101                          101
             101                          101
             101              111111111111101
 1           101             1000000000000001
101           1              1001111111111111
121                          121
101                          101
1N1                          101
101                          101
10011111111111111111111111111001
10000000000020000000000000000001
11111111111111111111111111111111
