R 1000 600

NO ./texture/WALL32.xpm
SO ./texture/WALL53.xpm
WE ./texture/WALL88.xpm
EA ./texture/WALL89.xpm
S ./texture/BAR1M0.xpm

F 255,255,255

C 255,255,255

1111111111111
122222S222221
1222220222221
1222220222221
1222220222221
1222220222221
1222220222221
1222220222221
1222220222221
1222220222221
1222220222221
1222220222221
1222220222221
1222220222221
1222220222221
1222220222221
1222220222221
1222220222221
1222220222221
1222220222221
1222220222221
1222220222221
1222220222221
1222220222221
1222220222221
1222220222221
1222220222221
1222220222221
1222220222221
1222220222221
1222220222221
1222220222221
1222220222221
1222220222221
1222220222221
1222220222221
1222220222221
1222220222221
1222220222221
1222220222221
1222220222221
1222220222221
1222220222221
1222220222221
1222220222221
1222220222221
1222220222221
1222220222221
1222220222221
1222220222221
1222220222221
1222220222221
1222220222221
1222220222221
1222220222221
1222220222221
1222220222221
1222220222221
1222220222221
1222220222221
1222220222221
1222220222221
1222220222221
1222220222221
1222220222221
1222220222221
1222220222221
1222220222221
1222220222221
1222220222221
1222220222221
1222220222221
1222220222221
1222220222221
1222220222221
1222220222221
1222220222221
1222220222221
1222220222221
1222220222221
1222220222221
1222220222221
1222220222221
1222220222221
1222220222221
1222220222221
1222220222221
1222220222221
1222220222221
1222220222221
1222220222221
1222220222221
1222220222221
1222220222221
1222220222221
1222220222221
1222220222221
1222220222221
1222220222221
1222220222221
1222220222221
1222220222221
1222220222221
1222220222221
1222220222221
1222220222221
1222220222221
1222220222221
1222220222221
1222220222221
1222220222221
1222220222221
1222220222221
1222220222221
1222220222221
1222220222221
1222220222221
1222220222221
1222220222221
1222220222221
1222220222221
1222220222221
1222220222221
1222220222221
1222220222221
1222220222221
1222220222221
1222220222221
1222220222221
1222220222221
1222220222221
1222220222221
1222220222221
1222220222221
1222220222221
1222220222221
1222220222221
1222220222221
1222220222221
1222220222221
1222220222221
1222220222221
1222220222221
1222220222221
1222220222221
1222220222221
1222220222221
1222220222221
1222220222221
1222220222221
1222220222221
1222220222221
1222220222221
1222220222221
1222220222221
1222220222221
1222220222221
1222220222221
1222220222221
1222220222221
1222220222221
1222220222221
1222220222221
1222220222221
1222220222221
1222220222221
1222220222221
1222220222221
1222220222221
1222220222221
1222220222221
1222220222221
1222220222221
1222220222221
1222220222221
1222220222221
1222220222221
1222220222221
1222220222221
1222220222221
1222220222221
1222220222221
1222220222221
1222220222221
1222220222221
1222220222221
1222220222221
1222220222221
1222220222221
1222220222221
1222220222221
1222220222221
1222220222221
1222220222221
1222220222221
1222220222221
1222220222221
1222220222221
1222220222221
1222220222221
1222220222221
1222220222221
1222220222221
1222220222221
1222220222221
1222220222221
1222220222221
1222220222221
1222220222221
1222220222221
1222220222221
1222220222221
1222220222221
1222220222221
1222220222221
1222220222221
1222220222221
1222220222221
1222220222221
1222220222221
1222220222221
1222220222221
1222220222221
1222220222221
1222220222221
1222220222221
1222220222221
1222220222221
1222220222221
1222220222221
1222220222221
1222220222221
1222220222221
1222220222221
1222220222221
1222220222221
1222220222221
1222220222221
1222220222221
1222220222221
1222220222221
1222220222221
1222220222221
1222220222221
1222220222221
1222220222221
1222220222221
1222220222221
1222220222221
1222220222221
1222220222221
1222220222221
1222220222221
1222220222221
1222220222221
1222220222221
1222220222221
1222220222221
1222220222221
1222220222221
1222220222221
1222220222221
1222220222221
1222220222221
1222220222221
1222220222221
1222220222221
1222220222221
1222220222221
1222220222221
1222220222221
1222220222221
1222220222221
1222220222221
1222220222221
1222220222221
1222220222221
1222220222221
1222220222221
1222220222221
1222220222221
1222220222221
1222220222221
1222220222221
1222220222221
1222220222221
1222220222221
1222220222221
1222220222221
1222220222221
1222220222221
1222220222221
1222220222221
1222220222221
1222220222221
1222220222221
1222220222221
1222220222221
1222220222221
1222220222221
1222220222221
1222220222221
1222220222221
1222220222221
1222220222221
1222220222221
1222220222221
1222220222221
1222220222221
1222220222221
1222220222221
1222220222221
1222220222221
1222220222221
1222220222221
1222220222221
1222220222221
1222220222221
1222220222221
1222220222221
1222220222221
1222220222221
1222220222221
1222220222221
1222220222221
1222220222221
1222220222221
1222220222221
1222220222221
1222220222221
1222220222221
1222220222221
1222220222221
1222220222221
1222220222221
1222220222221
1222220222221
1222220222221
1222220222221
1222220222221
1222220222221
1222220222221
1222220222221
1222220222221
1222220222221
1222220222221
1222220222221
1222220222221
1222220222221
1222220222221
1222220222221
1222220222221
1222220222221
1222220222221
1222220222221
1222220222221
1222220222221
1222220222221
1222220222221
1222220222221
1222220222221
1222220222221
1222220222221
1222220222221
1222220222221
1222220222221
1222220222221
1222220222221
1222220222221
1222220222221
1222220222221
1222220222221
1222220222221
1222220222221
1222220222221
1222220222221
1222220222221
1222220222221
1222220222221
1222220222221
1222220222221
1222220222221
1222220222221
1222220222221
1222220222221
1222220222221
1222220222221
1222220222221
1222220222221
1222220222221
1222220222221
1222220222221
1222220222221
1222220222221
1222220222221
1222220222221
1222220222221
1222220222221
1222220222221
1222220222221
1222220222221
1222220222221
1222220222221
1222220222221
1222220222221
1222220222221
1222220222221
1222220222221
1222220222221
1222220222221
1222220222221
1222220222221
1222220222221
1222220222221
1222220222221
1222220222221
1222220222221
1222220222221
1222220222221
1222220222221
1222220222221
1222220222221
1222220222221
1222220222221
1222220222221
1222220222221
1222220222221
1222220222221
1222220222221
1222220222221
1222220222221
1222220222221
1222220222221
1222220222221
1222220222221
1222220222221
1222220222221
1222220222221
1222220222221
1222220222221
1222220222221
1222220222221
1222220222221
1222220222221
1222220222221
1222220222221
1222220222221
1222220222221
1222220222221
1222220222221
1222220222221
1222220222221
1222220222221
1222220222221
1222220222221
1222220222221
1222220222221
1222220222221
1222220222221
1222220222221
1222220222221
1222220222221
1222220222221
1222220222221
1222220222221
1222220222221
1222220222221
1222220222221
1222220222221
1222220222221
1222220222221
1222220222221
1222220222221
1222220222221
1222220222221
1222220222221
1222220222221
1222220222221
1222220222221
1222220222221
1222220222221
1222220222221
1222220222221
1222220222221
1222220222221
1222220222221
1222220222221
1222220222221
1222220222221
1222220222221
1222220222221
1222220222221
1222220222221
1222220222221
1222220222221
1222220222221
1222220222221
1222220222221
1222220222221
1222220222221
1222220222221
1222220222221
1222220222221
1222220222221
1222220222221
1222220222221
1222220222221
1222220222221
1222220222221
1222220222221
1222220222221
1222220222221
1222220222221
1222220222221
1222220222221
1222220222221
1222220222221
1222220222221
1222220222221
1222220222221
1222220222221
1222220222221
1222220222221
1222220222221
1222220222221
1222220222221
1222220222221
1222220222221
1222220222221
1222220222221
1222220222221
1222220222221
1222220222221
1222220222221
1222220222221
1222220222221
1222220222221
1222220222221
1222220222221
1222220222221
1222220222221
1222220222221
1222220222221
1222220222221
1222220222221
1222220222221
1222220222221
1222220222221
1222220222221
1222220222221
1222220222221
1222220222221
1222220222221
1222220222221
1222220222221
1222220222221
1222220222221
1222220222221
1222220222221
1222220222221
1222220222221
1222220222221
1222220222221
1222220222221
1222220222221
1222220222221
1222220222221
1222220222221
1222220222221
1222220222221
1222220222221
1222220222221
1222220222221
1222220222221
1222220222221
1222220222221
1222220222221
1222220222221
1222220222221
1222220222221
1222220222221
1222220222221
1222220222221
1222220222221
1222220222221
1222220222221
1222220222221
1222220222221
1222220222221
1222220222221
1222220222221
1222220222221
1222220222221
1222220222221
1222220222221
1222220222221
1222220222221
1222220222221
1222220222221
1222220222221
1222220222221
1222220222221
1222220222221
1222220222221
1222220222221
1222220222221
1222220222221
1222220222221
1222220222221
1222220222221
1222220222221
1222220222221
1222220222221
1222220222221
1222220222221
1222220222221
1222220222221
1222220222221
1222220222221
1222220222221
1222220222221
1222220222221
1222220222221
1222220222221
1222220222221
1222220222221
1222220222221
1222220222221
1222220222221
1222220222221
1222220222221
1222220222221
1222220222221
1222220222221
1222220222221
1222220222221
1222220222221
1222220222221
1222220222221
1222220222221
1222220222221
1222220222221
1222220222221
1222220222221
1222220222221
1222220222221
1222220222221
1222220222221
1222220222221
1222220222221
1222220222221
1222220222221
1222220222221
1222220222221
1222220222221
1222220222221
1222220222221
1222220222221
1222220222221
1222220222221
1222220222221
1222220222221
1222220222221
1222220222221
1222220222221
1222220222221
1222220222221
1222220222221
1222220222221
1222220222221
1222220222221
1222220222221
1222220222221
1222220222221
1222220222221
1222220222221
1222220222221
1222220222221
1222220222221
1222220222221
1222220222221
1222220222221
1222220222221
1222220222221
1222220222221
1222220222221
1222220222221
1222220222221
1222220222221
1222220222221
1222220222221
1222220222221
1222220222221
1222220222221
1222220222221
1222220222221
1222220222221
1222220222221
1222220222221
1222220222221
1222220222221
1222220222221
1222220222221
1222220222221
1222220222221
1222220222221
1222220222221
1222220222221
1222220222221
1222220222221
1222220222221
1222220222221
1222220222221
1222220222221
1222220222221
1222220222221
1222220222221
1222220222221
1222220222221
1222220222221
1222220222221
1222220222221
1222220222221
1222220222221
1222220222221
1222220222221
1222220222221
1222220222221
1222220222221
1222220222221
1222220222221
1222220222221
1222220222221
1222220222221
1222220222221
1222220222221
1222220222221
1222220222221
1222220222221
1222220222221
1222220222221
1222220222221
1222220222221
1222220222221
1222220222221
1222220222221
1222220222221
1222220222221
1222220222221
1222220222221
1222220222221
1222220222221
1222220222221
1222220222221
1222220222221
1222220222221
1222220222221
1222220222221
1222220222221
1222220222221
1222220222221
1222220222221
1222220222221
1222220222221
1222220222221
1222220222221
1222220222221
1222220222221
1222220222221
1222220222221
1222220222221
1222220222221
1222220222221
1222220222221
1222220222221
1222220222221
1222220222221
1222220222221
1222220222221
1222220222221
1222220222221
1222220222221
1222220222221
1222220222221
1222220222221
1222220222221
1222220222221
1222220222221
1222220222221
1222220222221
1222220222221
1222220222221
1222220222221
1222220222221
1222220222221
1222220222221
1222220222221
1222220222221
1222220222221
1222220222221
1222220222221
1222220222221
1222220222221
1222220222221
1222220222221
1222220222221
1222220222221
1222220222221
1222220222221
1222220222221
1222220222221
1222220222221
1222220222221
1222220222221
1222220222221
1222220222221
1222220222221
1222220222221
1222220222221
1222220222221
1222220222221
1222220222221
1222220222221
1222220222221
1222220222221
1222220222221
1222220222221
1222220222221
1222220222221
1222220222221
1222220222221
1222220222221
1222220222221
1222220222221
1222220222221
1222220222221
1222220222221
1222220222221
1222220222221
1222220222221
1222220222221
1222220222221
1222220222221
1222220222221
1222220222221
1222220222221
1222220222221
1222220222221
1222220222221
1222220222221
1222220222221
1222220222221
1222220222221
1222220222221
1222220222221
1222220222221
1222220222221
1222220222221
1222220222221
1222220222221
1222220222221
1222220222221
1222220222221
1222220222221
1222220222221
1222220222221
1222220222221
1222220222221
1222220222221
1222220222221
1222220222221
1222220222221
1222220222221
1222220222221
1222220222221
1222220222221
1222220222221
1222220222221
1222220222221
1222220222221
1222220222221
1222220222221
1222220222221
1222220222221
1222220222221
1222220222221
1222220222221
1222220222221
1222220222221
1222220222221
1222220222221
1222220222221
1222220222221
1222220222221
1222220222221
1222220222221
1222220222221
1222220222221
1222220222221
1222220222221
1222220222221
1222220222221
1222220222221
1222220222221
1222220222221
1222220222221
1222220222221
1222220222221
1222220222221
1222220222221
1222220222221
1222220222221
1222220222221
1222220222221
1222220222221
1222220222221
1222220222221
1222220222221
1222220222221
1222220222221
1222220222221
1222220222221
1222220222221
1222220222221
1222220222221
1222220222221
1222220222221
1222220222221
1222220222221
1222220222221
1222220222221
1222220222221
1222220222221
1222220222221
1222220222221
1222220222221
1222220222221
1222220222221
1222220222221
1222220222221
1222220222221
1222220222221
1222220222221
1222220222221
1222220222221
1222220222221
1222220222221
1222220222221
1222220222221
1222220222221
1222220222221
1222220222221
1222220222221
1222220222221
1222220222221
1222220222221
1222220222221
1222220222221
1222220222221
1222220222221
1222220222221
1222220222221
1222220222221
1222220222221
1222220222221
1222220222221
1222220222221
1222220222221
1222220222221
1222220222221
1222220222221
1222220222221
1222220222221
1222220222221
1222220222221
1222220222221
1222220222221
1222220222221
1222220222221
1222220222221
1222220222221
1222220222221
1222220222221
1222220222221
1222220222221
1222220222221
1222220222221
1222220222221
1222220222221
1222220222221
1222220222221
1222220222221
1222220222221
1222220222221
1222220222221
1222220222221
1222220222221
1222220222221
1222220222221
1111111111111
