F 255,255,255
C 255,255,255
R 1000 600
NO ./texture/WALL32.xpm
SO ./texture/WALL53.xpm
WE ./texture/WALL88.xpm
EA ./texture/WALL89.xpm

S ./texture/BAR1M0.xpm
11
1  1
11           111111111111111111111111111111111111111111111111111111111111111111111111111111111111111111111111111111111111111111111111111111111111111111111111111111111111111111111111111111111111111111111111111111111111111111111111111111111111111111111111111111111111111111111111111111111111111111111111111111111111111111111111111111111111111111111111111111111111111111111111111111111111111111111111111111111111111111111111111111111111111111111111111111111111111111111111111111111111111111111111
             100000000000200000000000000000000000000000200000000000000000000000000000200000000000000000000000000000200000000000000000000000000000200000000000000000000000000000200000000000000000000000000000200000000000000000000000000000200000000000000000000000000000200000000000000000000000000000200000000000000000000000000000200000000000000000000000000000200000000000000000000000000000200000000000000000000000000000200000000000000000000000000000200000000000000000000000000000200000000000000001
             100111111111111111111111111110011111111111111111111111111111111111111111111111111111111111111111111111111111111111111111111111111111111111111111111111111111111111111111111111111111111111111111111111111111111111111111111111111111111111111111111111111111111111111111111111111111111111111111111111111111111111111111111111111111111111111111111111111111111111111111111111111111111111111111111111111111111111111111111111111111111111111111111111111111111111111111111111111111111111111111
             101                          101
             101                          101
             101              111111111111101
 1           101             1000000000000001
101           1              1001111111111111
121                          121
101       111111             101
101                          101
101                          101
10011111111111111111111111111001 11
100000000000200000N0000000000001 101
11111111111111111111111111111111 111
                                           1
1
